schweiz	suisse
schweizerisch	suisse
politisch	politique
föderalismus	fédéralisme
kantone	cantons
gemeinden	municipalités
departement	département
institut	institut
wirkung	effet
verordnung	réglementation
gesetze	lois
bürger	citoyen
bürgerschaft	citoyenneté
migration	migration
auswirkungen	effets
rente	pension
beiträge	contributions
ämter	bureaux
berechtigt	autorisé
inländer	national
ausländer	étrangers
sektor	secteur
plan	plan
massnahmen	mesures
abstimmung	vote
inland	national
ausland	étranger
ebene	niveau
durchschnittlich	moyenne
auswirkungen	effets
präsident	président
steuern	taxes
staat	état
staatlich	public
privat	privé
öffentlich	public
rechtlich	juridique
gericht	tribunal
verfassung	constitution
europa	europe
beruflich	professionnel
bern	berne
zürich	zurich
teuerung	inflation
zunahme	augmentation
fortschritte	progrès
entscheid	décision
revision	révision
franken	francs
projekt	projet
dienstleistung	service
personal	personnel
arbeitgeber	employeur
arbeitnehmer	employés
behörden	autorités
gewerbe	commerce
mitglied	membre
umwelt	environnement
verband	association
gremium	commission
untersuchung	enquête
lösung	solution
problem	problème
ausbildung	formation
unterricht	cours
schulde	doit
zustimmung	consentement
ablehnung	rejet
volk	personnes
statistik	statistiques
ziele	objectifs
verkehr	trafic
kapazität	capacité
referendum	référendum
initiative	initiative
motion	motion
antrag	proposition
===	===
reformprozesses	réformes
kalkulieren	calculer
realistisch	réaliste
verletzung	violation
volkswirtschaft	économie
finanziertes	financé
kongresse	conférences
entgegenstanden	opposées
abwesenden	absents
ballungseffekten	solidement
kommunalwahlen	locales
verwaltungsautonomie	autonomie
kulturbereichen	culturels
regierungspräsidenten	présidente
änderungsanzeigen	annonces
aromatisches	aromatique
standfestem	résistants
ausnutzt	profitera
pestizidkonzentration	concentrations
illegal	illégal
halbjahresberichte	semestriel
benutzer	utilisateurs
pachtende	fermiers
kultursektor	culture
familientradition	tradition
sammelung	collection
aussenpolitik	politique
organigramms	organigramme
kosteneffizientere	rentables
betitelt	intitulée
diversifiziertes	diversifié
verständnis	connaissance
agrarwissenschaftlichen	agronomiques
umbrüchen	ruptures
vorbereitetem	boulangerie
kulturministers	ministre
aufenthaltserlaubnis	possession
rückverfolgbarkeitssystem	traçabilité
transparentesten	transparentes
heimlicher	clandestine
brennstoffzelle	combustible
üblicheren	habituels
kostenkalkulationen	calculs
vorsorgeverhältnisse	prévoyance
übernationalen	supranational
konzentrate	concentrés
vernichteter	détruites
gewerbezentrum	industriel
gründlichem	solides
einfordern	prélever
recyclings	recyclés
innovativsten	innovante
verordnen	ordonner
variierenden	variables
ausgleichsbedarfs	équilibrage
wirtschaftssystemen	économies
zufriedenstellendere	satisfaisants
inkorrekt	incorrecte
sphärische	sphérique
rollstühle	fauteuil
erfolge	résultats
anbindung	indexation
beilhilfen	compenser
sozialer	sociales
vermutete	présumé
ausschliesslichem	exclusive
winzern	viticulteurs
humanitärem	humanitaires
zerfall	effondrement
parlamentes	parlement
verkündeten	proclamé
lohnsumme	salaires
untergründen	substrats
stellvertreterinnen	remplaçants
geänderter	révisée
sparsamkeit	efficience
abrüstungspolitik	désarmement
verfügbare	accessibles
erhärten	confirmer
gleichwohl	toutefois
expertise	expertise
ehrgeizigeren	ambitieuse
logistisches	logistique
bilaterale	bilatérale
bankautomaten	bancaires
plakaten	affichage
besuchen	visites
aufstrebende	émergents
bekämpfen	attaquer
selbstständige	autonomes
widerstands	résistance
katastrophal	catastrophiques
gemüsen	légumes
gezüchtet	cultivées
beaufsichtigungen	surveillances
kompletten	complète
vielseitige	diversifié
annulierte	annulés
behinderungen	invalides
konzeption	conception
ungewisses	incertain
gleichwertiges	équivalent
mindestbesteuerungssatz	respectés
vorzugspartizipationsscheinen	privilégiés
düngemischungen	fertilisants
unabhängigkeit	impartialité
sardinengewicht	sardines
anonymisierte	anonymes
explosivem	explosible
kompetenz	aptitudes
kontrastes	contraste
privatvermögens	fortune
valable	valable
wiederaufgebauten	reconstruites
